10 10
0 1 2 3 4 5 6 7 0 1
0 0 0 0 0 0 0 0 0 0
0 0 0 0 0 0 0 0 1 1
0 0 0 0 0 0 0 0 0 0
0 0 0 0 2 5 0 2 2 4
0 0 0 0 0 0 0 0 0 0
0 0 0 -1 0 0 -1 0 0 0
1 1 0 0 0 0 0 0 0 0
0 0 0 0 0 0 0 0 0 0
0 1 2 3 4 5 6 7 0 1