10 10
4 1 2 3 4 5 6 7 2 1
2 4 5 3 6 1 2 3 4 1
1 2 3 4 5 6 7 3 4 6
5 6 3 4 2 5 1 5 6 7
1 4 5 2 3 5 4 6 5 1
1 3 2 4 3 5 4 6 5 7
7 6 5 4 3 2 1 7 6 1
6 3 2 4 5 2 1 4 7 5
1 3 2 1 7 4 6 5 3 4
4 1 2 3 4 5 6 7 2 1